3 
4 
5  27 42 57 
6  12 27 39 46 54 
7  02 08 16 23 31 38 46 53 
8  01 08 16 23 31 38 46 53 
9  01 08 16 23 31 38 46 53 
10  01 08 16 23 31 38 46 53 
11  01 08 16 23 31 38 46 53 
12  01 08 16 23 31 38 46 53 
13  01 08 17 25 32 39 47 54 
14  02 09 17 24 32 39 47 54 
15  02 09 17 24 31 39 46 54 
16  01 09 16 24 31 39 46 54 
17  01 09 16 24 31 39 46 54 
18  01 09 16 24 31 39 46 54 
19  01 09 15 22 29 38 46 54 
20  01 08 16 23 30 38 45 58 
21  13 28 43 58 
22  13 28 41 56 
23 
