4 
5  27 43 58 
6  13 29 39 44 49 54 59 
7  04 09 14 19 24 29 34 39 44 49 54 59 
8  04 09 14 19 24 29 34 39 44 49 54 59 
9  04 09 14 19 24 29 34 39 44 49 54 
10  00 06 14 21 29 36 44 51 59 
11  06 14 21 29 36 44 51 59 
12  06 14 21 29 36 44 51 59 
13  06 16 23 31 38 45 53 
14  01 08 16 23 31 38 45 53 
15  01 08 16 21 26 30 36 41 46 51 56 
16  00 06 11 15 21 26 30 36 41 45 51 56 
17  00 06 11 15 21 26 30 36 41 45 51 56 
18  00 06 11 16 21 26 31 36 41 46 51 56 
19  01 06 10 16 22 29 36 44 51 59 
20  06 14 20 27 35 43 50 
21  01 16 23 31 46 
22  01 16 26 41 56 
23  12 26 
0 
