3 
4  45 
5  00 15 30 45 57 
6  03 09 14 18 24 29 34 39 44 49 54 59 
7  04 09 14 19 24 29 34 39 44 49 54 59 
8  04 09 14 19 24 29 34 39 44 49 54 59 
9  05 10 15 22 30 37 45 52 
10  00 08 15 23 30 38 45 53 
11  00 08 15 23 30 38 45 53 
12  00 08 15 23 30 38 45 53 
13  00 08 15 23 30 38 45 53 
14  00 08 15 21 25 30 35 40 45 50 55 
15  00 05 10 15 20 25 30 35 40 45 50 55 
16  00 05 10 15 20 25 30 35 40 45 50 55 
17  00 05 10 15 20 25 30 35 40 45 50 55 
18  02 09 17 23 29 34 40 45 49 55 
19  02 09 17 25 32 40 47 54 
20  02 10 22 37 52 
21  07 22 37 52 
22  07 22 37 52 
23  07 
0 
