3 
4  56 
5  07 18 37 45 53 
6  02 12 20 28 35 43 50 58 
7  05 13 20 28 35 43 50 58 
8  05 13 20 28 35 43 50 58 
9  05 12 20 27 35 42 50 57 
10  05 12 20 27 35 42 50 57 
11  05 12 20 27 35 42 50 57 
12  05 12 20 27 35 42 50 57 
13  05 12 20 27 35 42 50 57 
14  05 12 20 27 35 42 50 57 
15  05 12 20 27 35 42 50 57 
16  05 12 20 27 35 42 50 57 
17  05 12 20 27 35 42 50 57 
18  05 12 20 27 35 42 50 57 
19  05 12 20 27 35 42 50 57 
20  05 14 29 44 59 
21  14 29 44 58 
22  13 29 44 58 
23 
